20 20
1 0
w,e,w,w,w,w,w,w,w,w,w,w,w,w,w,w,w,w,w,w
w,e,e,w,w,e,w,e,w,w,e,e,e,e,w,e,e,w,e,w
w,e,w,w,e,e,e,e,e,w,w,e,w,w,w,e,w,w,e,w
w,e,w,w,w,w,w,w,e,e,w,e,w,w,e,e,e,e,e,w
w,e,e,w,w,e,w,w,e,w,w,e,w,w,e,w,w,w,w,w
w,e,w,w,w,e,e,w,e,w,w,e,w,w,e,w,w,w,e,w
w,e,e,e,w,w,e,e,e,w,w,e,w,w,e,e,e,e,e,w
w,e,w,w,w,w,w,w,e,w,w,e,e,e,e,w,w,w,w,w
w,e,e,w,w,e,w,w,e,w,e,e,w,w,e,e,e,e,e,w
w,e,w,w,e,e,e,w,e,e,e,w,w,w,w,w,e,w,e,w
w,e,e,w,w,w,e,e,e,w,e,e,w,e,w,w,w,w,w,w
w,w,e,e,w,w,w,w,e,w,w,w,w,e,e,e,w,e,w,w
w,w,w,e,e,e,e,e,e,w,w,e,e,e,w,e,e,e,e,w
w,e,w,w,w,w,e,w,w,w,e,e,w,w,w,w,w,w,w,w
w,e,e,w,e,e,e,e,e,e,e,w,w,w,e,e,e,w,w,w
w,w,e,w,w,w,e,w,e,w,w,w,e,e,e,w,w,w,e,w
w,w,e,w,e,e,e,w,e,e,e,w,w,w,e,e,e,e,e,w
w,e,e,e,e,w,e,w,e,w,w,w,w,e,e,w,e,w,e,w
w,e,w,w,e,w,e,w,e,e,e,e,e,e,w,w,e,w,e,w
w,w,w,w,w,w,w,w,w,w,w,w,w,w,w,w,w,w,e,w